12,12,12,12,12,12,12,12,12,12
12,12,12,12,12,12,12,12,12,12
12,12,12,12,12,12,12,12,12,12
12,8,8,8,8,103,101,103,8,12
12,12,8,8,8,8,103,103,11,12
12,8,8,8,8,11,11,11,11,12
12,12,8,8,8,8,8,8,11,12
12,202,102,202,102,202,102,202,102,12
12,12,11,8,8,8,8,8,8,12
12,11,11,11,11,8,8,8,8,12
12,12,11,203,203,8,8,8,8,12
12,8,203,201,203,8,8,8,8,12
12,12,12,12,12,12,12,12,12,12
12,12,12,12,12,12,12,12,12,12